^^^^^^^^^^^^^^^^^^^^^^^^^^^^^^^^^^^^^^^^^^^^^^^^^^
^^^^^^^^^^^^^^^^^^^^^^^^^^^^^^^^^^^^^^^^^^^^^^^^^^
^^^^^^^^^^^^^^^^^^^^^^^^^^^^^^^^^^^^^^^^^^^^^^^^^^
^^^^^^^^^^^^^^^^^^^^^^^^^^^^^^^^^^^^^^^^^^^^^^^^^^
^^^^^^^^^^^^^^&&&&&^^^^V^^^^^^^^^^^^^^^^^^^^^^^^^^
^^^^^^^^^^^V&&&&&&&&&&&&&^^V^^^^^^^^^^^^^^^^^^^^^^
^^^^^^^^^^^&&&VPV&&&&&&&&&&^^V^^^^^^^V^^^^^^^^^^^^
^^^^^~^^^^^&&&P P&&&&&&&&&&&&&^^^^V,&&&V^^^^^^^^^^
^^^^~~~~^^^^&&VPV&&&&&&&&&~~~&&^^&&&&&,^^^^^^^^^^^
^^^^~~~~^^^V&&&&&&&&&&&&&&~Q=,,,&&&&&,,>^^^^^^^^^^
^^^^~~~~^^^^^&&&&&&&&&&&&&~~~&&,&&&&&&,^^^^^^^^^^^
^^^^~~~~~^^^^V&&'&&&&&&&&&&&&&&,&&&&&&V^^^^^^^^^^^
^^^~~^^^~~~^^^^''&&&&&&&&&&&&&&,&&&&^^^^^^^^^^^^^^
^^^~^^^^^^~^^'''''&&####&&&&&&&,&&&V^V^^^^^^^^^^^^
^^^^^^^^^^~~~'''''''#h:#&&&&&&&,########^^^^^^^^^^
^^^^^^^^^^^^~~~'''''#..#&&&&&&&,#.hOh..#^^^^^^^^^^
^^^^^^^^^^VV^~~~~~,,#x##'''''&&,#......#^^^^^^^^^^
^^^^^^^^^^^^'''',=',,,''''''''',x...##x#^^^^^^^^^^
^^^^^^^^^^^^'''',~~'''''''''''''#...#..#^^^^^^^^^^
^^^^^^^^^######','~~~''''''~~~~~##x##?:#^^^^^^^^^^
^^^^^^^^^#hOh.#','''~~~'''~~'''~'','####^^^^^^^^~^
^^^^^^^^^#....x,,'''''~~~~~'',,=,,,'''^V^^^^^^^~~^
^^^^^^^^^#:?..#','''''~'''''','~~'''''^^^V^^^^~~^^
^^^^^^^^^######','''''~'''''',''~~~~~~~~~~~~~~~^^^
^^^^^^^^^^'''''',,,,,,=,,,,,,,''''''''''V^^^^^^^^^
^^^^^^^^ +'''',,,'''''~'','''''''''''''''^^^^^^^^^
^^^^^^^^^^'''',''''''~~'',''''''''"""""''^^^^^^^^^
^^^^^^^^^V'###x##'''~~''',''''''''"""""''^^^^^^^^^
^^^^^^^^^^'#?...#''~~'''',''''''''"""""''^^^^^^^^^
^^^^^^^^^^'#h...#''~''''',,,,,,,,,"""""^V^^V^^^^^^
^^^^^^^^^V'#Oh.:#'~~''''',''',''',"""""^^^^^^^^^^^
^^^^^^^^^^^######'~'''""""''""""',"""""^^V^^^^^^^^
^^^^^^^^^^^^''''''~'''""""''""""',''''^V^^^^^VVV^^
^^^^^^^^^^^^V^'''~~'''""""''""""',,,'^V^^^^^;;;W^^
^^^^^^^^^^^^^^^^V~''''""""''""""''','^^^^V;;;;;V^^
^^^^^^^^^^^^^^^^^~^'''""""''""""'^','^^;;;;;;VV^^^
^^^^^^^^^^^^^^^^^~VV^'""""''""""^^^'';;;;;;V^^^^^^
^^^^^^^^^^^^^^^^^~^^^^^''''''''^^^V^';;;V^^^^^^^^^
^^^^^^^^^^^^^^^^~^^^^^^^^'''''^^^^^^^V^^^^^^^^^^^^
^^^^^^^^^^^^^^^V~^^^^^^^^^^^^^^^^^^^^^^^^^^^^^^^^^
^^^^^^^^^^^^^^^^~^^^^^^^^^^^^^^^^^^^^^^^^^^^^^^^^^
^^^^^^^^^^^^^^^^~^^^^^^^^^^^^^^^^^^^^^^^^^^^^^^^^^
^^^^^^^^^^^^^^^~~^^^^^^^^^^^^^^^^^^^^^^^^^^^^^^^^^
^^^^^^^^^^^^^^~~^^^^^^^^^^^^^^^^^^^^^^^^^^^^^^^^^^
^^^^^^^^^^^^^~~^^^^^^^^^^^^^^^^^^^^^^^^^^^^^^^^^^^
^^^^^^^^^^^~~~~^^^^^^^^^^^^^^^^^^^^^^^^^^^^^^^^^^^
^^^^^^^^^^^~~~~^^^^^^^^^^^^^^^^^^^^^^^^^^^^^^^^^^^
^^^^^^^^^^^~~~^^^^^^^^^^^^^^^^^^^^^^^^^^^^^^^^^^^^
^^^^^^^^^^^^^^^^^^^^^^^^^^^^^^^^^^^^^^^^^^^^^^^^^^
^^^^^^^^^^^^^^^^^^^^^^^^^^^^^^^^^^^^^^^^^^^^^^^^^^
